6
*********************
*****###*************
****#   #************
****#$ $#************
***##   #************
**#  @$  #***********
*## u$uu #****####***
#   u uu #####  ..#**
# $  $          ..#**
*#### uuu # ##  ..#**
****#     ##**####***
*****#####***********
*********************
*********************
*********************
*********************
*********************
*********************
*********************
*********************
*********************
