32
*********************
*********************
*********************
**#****#######*###***
*# ####       #   #**
#  $   $$  $@$ ...#**
# $$$$u    $  u...#**
#   $ u $$ $$ u...#**
*#u   u  $    u...#**
#     u $ $ $ u...#**
#    uuuuuu uuu...#**
*# u  u $   $ u...#**
#  uu u $$ $  uu..#**
# ..u u $    $  u.#**
# ..u u $$$ $$$ u.#**
*#### u       u u.#**
****# uuuuuuuuu u.#**
****#           #.#**
*****########### #***
*********************
*********************
