14
*********************
*********************
*********************
***********##********
******##**#  #*******
****##  ###$ #*******
***#     $   #*******
**#  $ $$uu #********
*#  u$uu     #*******
*# u @$  $u$u#*******
*#   $ u  u $ ####***
**#u    u   $ u   #**
*#uu uu   $     $ #**
#.    u##  #######***
#.. ..#**##**********
#...u.#**************
#.....#**************
*#####***************
*********************
*********************
*********************
