10
*********************
*********************
*********************
*********************
*********************
***####*#####********
**#..  #     ##******
**#..  u $  $  #*****
**#..  u$uuuu$ #*****
**#..      uu@ #*****
**#..  u u    #******
***##uuu uu$$  #*****
****# $  $ $ $ #*****
****#    u     #*****
*****####*#####******
*********************
*********************
*********************
*********************
*********************
*********************


