11
*********************
*********************
*********************
*********************
*********************
**********######*****
*********#      #****
*********# $u$ #*****
*********#  @$$#*****
**********#$ $ #*****
**######*# $ u ##****
*#....  #u $  $  #***
**#...    $  $   #***
*#....   ########****
**#######************
*********************
*********************
*********************
*********************
*********************
*********************

