20
*********************
*********************
*********************
*********************
************######***
***********#  ....#**
*####*######  ....#**
#    #  $ $   ....#**
# $$$u$  @$u  ....#**
#       $$ u  ....#**
#  $ u$ $ $#######***
#  $ u     #*********
*# uuuuuuu#**********
#    u    #**********
# $       #**********
# $$$u$$   #*********
#    #    #**********
*####*####***********
*********************
*********************
*********************

