12
*********************
*********************
*********************
*********************
**********###********
*********#   #*##****
*********# u$uu  #***
*********#     $ #***
**######*# uuu$  #***
*#....  #u $   ##****
*#....   $@  $ #*****
*#....  #u$ $$  #****
**######*#  $  #*****
*********# $ $  #****
**********## uu #****
***********#    #****
************####*****
*********************
*********************
*********************
*********************
