10
*********************
*********************
*********************
*********************
*********************
*****####****#*******
****#..  #### #******
****#..  uuu   #*****
****#..     $@ #*****
****#..  u u$$ #*****
****#..uuu u   #*****
*****### $ u$$ #*****
*******#  $u $ #*****
*******# $  $  #*****
*******#  ##   #*****
********##**###******
*********************
*********************
*********************
*********************
*********************


