11
*********************
*********************
*********************
*********************
*********************
***********###*******
*****#*##*#   #******
****# #  #u$ $ #*****
***#     $   $ #*****
***# $ $ uuu   #*****
****#u uu##u ##******
***# $  uuu ..#******
***#   @ $ ...#******
***# $ $uuu...#******
***# $  ###...#******
***#  ##***###*******
****##***************
*********************
*********************
*********************
*********************
