18
*********************
*********************
*********************
*****##**************
****#  ##########****
****#    $   $ $ #***
****# $u $ u  $  #***
****#  $ $  u    #***
***## $u u$ uuuu #***
**# u$ $ $@ uu   #***
**#     $u u   u #***
**# $      $ $ $ #***
***##uu  uu######****
****#      #*********
****#      #*********
****#......#*********
****#......#*********
****#......#*********
*****######**********
*********************
*********************
