14
*********************
*********************
*********************
*************#####***
************#  ...#**
*********####  ...#**
********#      . .#**
********#  uu  ...#**
*********# uu  ...#**
********## uuuuuu#***
*******# $$$ u####***
****#### $@ $ uuu#***
***#   u  $   u   #**
**#  $      $   $ #**
***#####$$$ $$####***
*******#      #******
********######*******
*********************
*********************
*********************
*********************
